#Special Tags
REB = "countries/Rebels.txt"
PIR = "countries/Pirates.txt"
NAT = "countries/Natives.txt"

#Eastern Drakaes
JVK = "countries/Jorvick.txt"
TRE = "countries/Treelords.txt"
ACC = "countries/AmarillianCatanianCommonwealth.txt"
AVA = "countries/Avaria.txt"
NID = "countries/Nidaros.txt"
YOA = "countries/NewYoake.txt"
SAR = "countries/SarorHaven.txt"
SME = "countries/Smegsville.txt"
#Western Drakaes
ABA = "countries/Abadyyenau.txt"
ACI = "countries/Aciester.txt"
AME = "countries/AmarilloEmpire.txt"
AMK = "countries/AmarilloKingdom.txt"
AMP = "countries/PuertoAmarillo.txt"
AND = "countries/Andliria.txt"
AQU = "countries/Aquatos.txt"
MUG = "countries/Mugen.txt"
KON = "countries/Konigsburg.txt"
SEB = "countries/Seeburg.txt"
TAE = "countries/Taernsbia.txt"
KEI = "countries/Kei.txt"
#Rest of Drakaesh
ACO = "countries/Acolytes.txt"
ADO = "countries/Andorn.txt"
#Katsura
#South Astios
#North Astios
ABN = "countries/Abaddon.txt"
AKI = "countries/Akirashalam.txt"
ALA = "countries/Alavan.txt"
ALI = "countries/Alitheia.txt"
APP = "countries/Applernia.txt"
ARC = "countries/AristiosCommonwealth.txt"
#Elaresh
AIO = "countries/Aionios.txt"
#West Phormyrr
BAR = "countries/Barbossa.txt"
UKA = "countries/Uraka.txt"
#East Phormyrr
ADR = "countries/Andor.txt"
AKA = "countries/Akarechi.txt"
#Onthukkan
ANG = "countries/Anglunia.txt"
#unordered
ALS = "countries/Alshire.txt"
AMA = "countries/Amagoria.txt"
APO = "countries/Apolis.txt"
AQL = "countries/Aquarianisland.txt"
AQR = "countries/Aquarius.txt"
AIC = "countries/Auralic.txt"
ARD = "countries/ARDUNE.txt"
ARE = "countries/AREVEYI.txt"
ARI = "countries/ARISTIOSEMPIRE.txt"
AUS = "countries/AUREUS.txt"
ACA = "countries/AURICA.txt"
ARK = "countries/ARKTANIA.txt"
AUC = "countries/AURICA2.txt"
ARS = "countries/AURUMSOLIS.txt"
ART = "countries/ARTHHOLDS.txt"
ARV = "countries/ANDROKVOST.txt"
ARX = "countries/ARXELLA.txt"
ASH = "countries/ASHAI.txt"
ASP = "countries/ASPELLA.txt"
ASR = "countries/ASRIA.txt"
AST = "countries/ASTRYA.txt"
AUR = "countries/AUREA.txt"
AVI = "countries/ARKTIS.txt"
ARX = "countries/ARXOLLAS.txt"
AXO = "countries/AXOLON.txt"
AYN = "countries/ASHARALYN.txt"
AZA = "countries/AZAD.txt"
AZR = "countries/AZURA.txt"
AZU = "countries/AZUMAZI.txt"
BAG = "countries/BAGRAT.txt"
BAL = "countries/BALISTAR.txt"
BAN = "countries/BANTOPIA.txt"
BEL = "countries/BARENLAND.txt"
BER = "countries/BERGFURT.txt"
BIS = "countries/BEL.txt"
BLD = "countries/BENLODORO.txt"
BLO = "countries/BLOMACHFOREST.txt"
BNL = "countries/BERNARDLAND.txt"
BOU = "countries/BOULDEROV.txt"
BSH = "countries/BERISH.txt"
BUC = "countries/BUCOVIA.txt"
CAI = "countries/CAISLEAN.txt"
CAN = "countries/CANAAN.txt"
CAT = "countries/CATANIA.txt"
CGN = "countries/COGNIA.txt"
CHE = "countries/CHEESELAIR.txt"
CHL = "countries/CHELSEA.txt"
CHV = "countries/CHEVKRI.txt"
CRI = "countries/CRIMSONREICH.txt"
CST = "countries/COSTA.txt"
CUM = "countries/NORICUM.txt"
DCW = "countries/DRAKAENCOMMONWEALTH.txt"
DDE = "countries/DANDELIONEMPIRE.txt"
DIR = "countries/DIREGON.txt"
DKB = "countries/DRAKAENKONTRYBUND.txt"
DKO = "countries/DRAKONIA.txt"
DKR = "countries/DRACKAR.txt"
DKY = "countries/DRUKYUL.txt"
DOK = "countries/DOKSAYA.txt"
DON = "countries/DONFUER.txt"
DTE = "countries/DA-TEI.txt"
DUL = "countries/DULFIKA.txt"
DWL = "countries/DRAKAENWESTENLANDES.txt"
EAG = "countries/EAGLEREACH.txt"
EDC = "countries/ELDERCREST.txt"
EDR = "countries/EDRINA.txt"
ELD = "countries/ELDURRIM.txt"
ELE = "countries/ELEANOR.txt"
ERB = "countries/EREBOR.txt"
EUC = "countries/EUCLIDEA.txt"
EXO = "countries/EXOUSIA.txt"
FAL = "countries/FALHOLT.txt"
FAR = "countries/FARREACH.txt"
FER = "countries/FEROWIND.txt"
FJH = "countries/FJHELLHEIM.txt"
FLK = "countries/FALSORIANKINGDOM.txt"
FOR = "countries/FORTUNA.txt"
FRA = "countries/FARANIA.txt"
FRE = "countries/FARENCIA.txt"
FYR = "countries/FYRATJUGO.txt"
GAR = "countries/GARDENIA.txt"
GAY = "countries/VALREACH.txt"
GFA = "countries/GRANDFARENCIA.txt"
GIR = "countries/GOLDEN.txt"
GLA = "countries/GLANRA.txt"
GOL = "countries/GOLDENSUNCITY.txt"
GOO = "countries/GOONDIUM.txt"
GRA = "countries/GRANDIA.txt"
GRO = "countries/GROMNOFIA.txt"
GUN = "countries/GUNJOU.txt"
GYE = "countries/GYEOUL.txt"
HAR = "countries/HARK.txt"
HEA = "countries/HEARTHSTONE.txt"
HEL = "countries/HELMING.txt"
HLD = "countries/HELDRAK.txt"
HOL = "countries/HOLLOW.txt"
HSH = "countries/HASHITO.txt"
HUS = "countries/HUSSARIA.txt"
IKK = "countries/IKKUL.txt"
ILL = "countries/ILLSER.txt"
ILU = "countries/ILLUMINA.txt"
IMD = "countries/IMPERIUMDRACONIS.txt"
IMP = "countries/IMPERIUM.txt"
IRE = "countries/IREMITH.txt"
IRI = "countries/IRITSU.txt"
IRK = "countries/IRULANKINGDOM.txt"
IRU = "countries/IRULAN.txt"
IUI = "countries/IUITTICAZ.txt"
JAB = "countries/JABAL.txt"
JVH = "countries/JORVHEIMR.txt"
KAA = "countries/KAANYIU.txt"
KAE = "countries/KAERHRAFIN.txt"
KAN = "countries/KANTARA.txt"
KAT = "countries/KATOLIS.txt"
KEL = "countries/KOEL.txt"
KIR = "countries/KIRUKO.txt"
KIS = "countries/KISH.txt"
KNI = "countries/THEKNIGHTS.txt"
KOD = "countries/KODNOR.txt"
KOR = "countries/KOROSECHEV.txt"
KOT = "countries/KOTUNNE.txt"
KTA = "countries/KATANIA.txt"
KTO = "countries/KATO.txt"
KUR = "countries/KURINGRAD.txt"
LAF = "countries/LAFROS.txt"
LEM = "countries/LEMOYNE.txt"
LIB = "countries/LIBERTAS.txt"
LIM = "countries/LIMURIA.txt"
LMU = "countries/LEMURIA.txt"
LOB = "countries/LOBLANTIS.txt"
LUN = "countries/LUNARIS.txt"
LUT = "countries/LUTUM.txt"
LUX = "countries/LUXENSTEIN.txt"
MAJ = "countries/MAJULAH.txt"
MAL = "countries/MALUCIA.txt"
MAP = "countries/MAPETRA.txt"
MCA = "countries/MERCAYTOR.txt"
MDL = "countries/MORDLADRON.txt"
MDR = "countries/TIR.txt"
MER = "countries/MERCURY.txt"
MET = "countries/METSALEJ.txt"
MIL = "countries/MILLENIA.txt"
MMC = "countries/MADMANSCROWNLANDS.txt"
MOR = "countries/MORDAINE.txt"
MOS = "countries/MOSIRSUMARI.txt"
MRK = "countries/MERKONIS.txt"
MUS = "countries/MUSHROOMICA.txt"
MYC = "countries/MYCORJI.txt"
MYK = "countries/MYKITAS.txt"
MYT = "countries/MYTRINIL.txt"
NCH = "countries/NACHTENREICH.txt"
NDR = "countries/NEODRAKAES.txt"
NEX = "countries/NEXUS.txt"
NIP = "countries/NIPPINGTON.txt"
NOR = "countries/NORIA.txt"
NSA = "countries/NEWSANCTUARY.txt"
NWS = "countries/NEWSANTOS.txt"
NST = "countries/NORTHSTAR.txt"
NTR = "countries/NUEVATRINIDAD.txt"
NUJ = "countries/NUJHARIA.txt"
NUV = "countries/NUVENOS.txt"
NVA = "countries/NORTH.txt"
NVR = "countries/NOVAREGNA.txt"
NVS = "countries/NOVASTONIA.txt"
NVZ = "countries/NOVAZEMJA.txt"
OFY = "countries/Oranje.txt"
OHG = "countries/OHIGHO.txt"
OLG = "countries/OLDGUARD.txt"
ONU = "countries/ONUMOZAKI.txt"
ORI = "countries/ORISFELL.txt"
OSR = "countries/OSRIA.txt"
OTH = "countries/OTHRIYA.txt"
OUR = "countries/OURITRIS.txt"
PAC = "countries/PACISTAN.txt"
PAV = "countries/PAVILEDO.txt"
PEN = "countries/PENOCK.txt"
PHO = "countries/PHOENIA.txt"
PIS = "countries/PISCES.txt"
PLA = "countries/PLAGATEA.txt"
POK = "countries/POKITARU.txt"
POL = "countries/POLIKOS.txt"
PRO = "countries/THE.txt"
QAD = "countries/QADAKH.txt"
RAI = "countries/RAIYUNA.txt"
RAR = "countries/RARIDAN.txt"
RAT = "countries/RATTICAN.txt"
RAV = "countries/RAVENGUARD.txt"
RDO = "countries/REDORIV.txt"
RDR = "countries/REGNUMDRAKAES.txt"
REV = "countries/REVELIA.txt"
RHF = "countries/RHEINFAULDER.txt"
RHL = "countries/RHINELAND.txt"
RIV = "countries/RIVERHEIM.txt"
RIZ = "countries/RIZZO.txt"
ROD = "countries/RODINNBROKK.txt"
ROK = "countries/ROKHIA.txt"
RWS = "countries/REDWATERSPRINGS.txt"
SAN = "countries/SANCTUS.txt"
SCY = "countries/SCYLDING.txt"
SEE = "countries/SEEKERSEND.txt"
SHI = "countries/SHATTERED.txt"
SHO = "countries/SHIROKANEZA.txt"
SHU = "countries/SHURIDA.txt"
SIG = "countries/SIGLAND.txt"
SIM = "countries/SALAMI.txt"
SKJ = "countries/SKJOLD.txt"
SKY = "countries/SKYRA.txt"
SLS = "countries/SOLIOSOS.txt"
SMS = "countries/SMEGAN.txt"
SNC = "countries/SANCTUS.txt"
SOD = "countries/SODALIS.txt"
SOL = "countries/SOLONIA.txt"
SOU = "countries/SOUMENIA.txt"
SQU = "countries/SQUATISTAN.txt"
STE = "countries/STELLARISIO.txt"
STH = "countries/SETHRIS.txt"
STM = "countries/STONEMANOR.txt"
STO = "countries/STONEGUARD.txt"
SUS = "countries/SUSTERA.txt"
SWA = "countries/SWARDIA.txt"
SYL = "countries/SYLVANIA.txt"
TAK = "countries/TAKAVIA.txt"
TAR = "countries/TARXIEN.txt"
TEM = "countries/TEMPESTA.txt"
TER = "countries/TERRANIA.txt"
TET = "countries/TETRA.txt"
TIT = "countries/TITANIA.txt"
TLO = "countries/TLOTA.txt"
TOR = "countries/TORHAM.txt"
TOV = "countries/TOVARHEIM.txt"
TRA = "countries/TERRATHER.txt"
TRT = "countries/TORTUGA.txt"
TSO = "countries/TSOL.txt"
TTR = "countries/TITANSREST.txt"
UCW = "countries/UNITEDCOMMONWEALTH.txt"
ULD = "countries/ULDARASH.txt"
ULF = "countries/ULFAENG.txt"
URK = "countries/URAK.txt"
URU = "countries/URUBIA.txt"
VAL = "countries/VALIA.txt"
VAR = "countries/VARNTORUM.txt"
VEL = "countries/VELENU.txt"
VES = "countries/VESPERA.txt"
VID = "countries/VIDANMOR.txt"
VIN = "countries/VINTAS.txt"
VIO = "countries/VIONIR.txt"
VIS = "countries/VISIO.txt"
VLK = "countries/VALKYRION.txt"
VLO = "countries/VALORE.txt"
VLR = "countries/VELERIN.txt"
VOC = "countries/VOCLARIA.txt"
VOL = "countries/VOLKARD.txt"
VRM = "countries/VERMILION.txt"
VSK = "countries/VESKALIDE.txt"
VUL = "countries/VULPERIUM.txt"
WIL = "countries/WILDONIA.txt"
WLM = "countries/WILMUND.txt"
WOL = "countries/WOLFINGRAD.txt"
WON = "countries/WONDERLAND.txt"
WRK = "countries/WHITERAVENKINGDOM.txt"
WWI = "countries/WOLFINWILDONIA.txt"
YAS = "countries/YASZUMA.txt"
YSZ = "countries/YASZRIA.txt"
YUV = "countries/YUVARIA.txt"
ZAI = "countries/ZAIDAN.txt"
ZAR = "countries/ZARISSIA.txt"
ZEM = "countries/ZEMINZKA.txt"
ZER = "countries/ZERRONA.txt"
ZHO = "countries/ZHON.txt"
